6
17 11  3  9  6 17  9  4  3  8  8  0  3  0 15  5
 7  1 18  6 17  4  2  9  8 19  8 12  3  4  5  8
 5  8 17  9  9 17  1 12  1  1 19  3  8  1  1  2
18  3  4 18  8  8 13 10 17  9 10 10  3 12 10  6
14  7 18  7 13  2  6  0 10 18 19 18 19  5  3  6
 7  1 18 11  3  5  7  0  0 15  5 19 16 11 18 14
16  8 10 14  5  5 17 17 18  0 15 17  9  9  4 17
 5  8 14  3 13 15  1 14 15 10  0  9 16 14 18 13
11  7 16  3 12  1  9  2 13  9 19  3 16  0  4 10
 3  5  8  0 12 14 17 12 16  1  4  6  9  7 13 15
19 17  8 10  8 10  3 16 19  7  8 13  9 14  8  2
 2 13  0 14  6  3 18 12  8  4  8  7 12  8  7 11
16  5 15  3  3  8 10 19 12 13  1 18 16 15  3  1
19 15 12 14  5  5 13  4 12 15 12 15 13  4  1  6
18 14 13  5  6  7 15 14 11 11 19 16 13 16  2 10
12 11 17  0 11  0  6  9 14 10 13 11 16 11 19  0
