2
14  6 16  9 12  8  1  3 17 16 18 17
17 16  2  5  2  4  9  2  9 19 14  9
 8 20  6 14 16  9 12 13 16  8  4 14
19 12 17  8 14  5 18  1  9 11  7 19
 2  5 19  5 17 12 14 19 14 15  8 19
 4 12 17 20 13 17 11  6 13 16 20 15
20 11 19  3 18 12  9  1  3  7  1 11
11 10  1 12  2  1 19  3  8  6  1  7
18  3  8  9  1 18 16 12  8 16  6  2
12  1 14  7 19 11  9 13 19 17 17 12
20 12  7 11  1 19 10  3  7 15  6 12
16 16 19 19  1 10 17  2  3 12 12  6
